Hello/Hi	Namaste	Namaste
How are you? (formal)	Aap kaise hain?	Aap kaise hain(nasal)
How are you? (informal)	Kya haal hai? /Kaise ho?/sab theek?	Kya haal hai/Kaise ho/Sab theek
I’m fine. You?	Main theek hoon. Tum?	Main theek hoon. Tum
What is your name? (formal)	Aapka naam kya hai?	Aap-ka naam kya hai
What is your name? (informal)	Tumhara naam kya hai?	Tum-hara naam kya hai
My name is Peter	Mera naam Peter hai.	Mera naam Peter hai
Thank you	Dhanyavad	Dhanya-vaad
Sorry	Maaf kijiye	Maaf ki-jie
Excuse me	Suniye	Sunie
See you!	Phir milenge	Phir milen-ge(nasal)
See you tomorrow	Kal milenge	Kal milen-ge(nasal)
Let’s go!	Chalo	Chalo
Yes	Haan	Haan (nasal)
No	Nahi	Nahi
Good	Accha	Acchaa
Great	Bahut accha	Bahut acchaa
Bad	Bura	Bura
Okay	Theek hai	Theek hai
Where are the restrooms?	Shauchalay kahan hai?	Shauch-alay kahan hai
How much does this cost?	Ye kitne ka hai?	Ye kit-ne ka hai
How much?	Kitna?	Kit-naa
Hurry up!	Jaldi karo	Jal-dee karo
I’m hungry	Mujhe bhookh lagi hai	Mujhe bhookh lagee hai
I’m thirsty	Mujhe pyaas lagi hai	Mujhe pyaas lagee hai
I don’t like this	Mujhe pasand nahi hai	Mujhe pasand nahee hai
I like this	Mujhe pasand hai	Mujhe pasand hai

Okay, all right	accha
Really?!	sach mein
Awesome! / Great!	vaah / vaah vaah
Well done! / Proud of you!	shabaash
Okay (filler word)	theek hai theek hai / badhiya
Really?	hain
Okay then (wrap up conversation)	accha chalo theek hai
Listen	suno
Tell me	haan bolo
Then / Okay / What else?	aur phir


0	shunya	shu-nya
1	ek	eik
2	do	do
3	teen	teen
4	char	chaar
5	panch	paanch (nasal)
6	che	cheh
7	saat	saat
8	aath	aath
9	nau	nau
10	das	das
20	bees	bees
30	tees	tees
40	chalis	chaa-lees
50	pachas	pa-chaas
60	sath	saath
70	sattar	sat-tar
80	assi	as-si
90	nabbey	nab-bey
100	sau	sau



Monday	Somvar	Som-vaar
Tuesday	Mangalvar	Mangal-vaar
Wednesday	Budhvar	Budh-vaar
Thursday	Guruvar	Guru-vaar
Friday	Shukrvar	Shukra-vaar
Saturday	Shanivar	Shani-vaar
Sunday	Ravivar	Ravi-vaar
Day	Din	Din
Week	Hafta	Haf-taa
Today	Aaj	Aaj
Tomorrow	Kal	Kal
Yesterday	Kal	Kal
Day after tomorrow	Parson	Par-son
Day before yesterday	Parson	Par-son
Someday	Kisi din	Kisi-din
Tonight	Aaj raat	Aaj raat
Tomorrow/Yesterday night	Kal raat	Kal raat
Next	Agla	Ag-laa
Last	Pichla	Pich-laa


Good	Accha	Ac-cha
Bad	Bura/Kharab	Bura/ Kha-raab
Raining	Barsaat	Bar-saat
Hot	Garm	Garm
Cold	Thanda	Thand-aa
Windy	Hava	Ha-vaa




Time	???	Samay
Date	?????	Tareekh
11:45 AM	???? ????	Paune-baa-rah
12 noon	????	Barah
12:15	??? ????	Sava-baa-rah
12:30	???? ????	Sade- baa-rah
3:45 PM	???? ???	Paune-chaar
4:00	???	Chaar
4:15	??? ???	Sava-chaar
4:30	???? ???	Sade-chaar
1:30	???	Ded
2:30	???	Dhaa-i
January 1st	?? ?????	Ek Jan-va-ree
10-Oct	?? ???????	Das Ak-too-ber




To be	Hona 	Ho-naa
To do	Karna	Kar-naa
To eat	Khana	Kha-naa
To drink	Peena	Pee-naa
To go	Jana	Ja-naa
To come	Ana	Aa-naa
To walk	Chalna	Chal-naa
To call	Bulana	Bula-naa
To see	Dekhna	Dekh-naa
To want	Chahna	Chah-naa
To give	Dena	De-naa
To like	Accha lagna	Ac-cha-lag-naa
To sleep	Sona	So-naa
To talk	Bolna	Bol-naa
To read	Padhna	Padh-naa
To write	Likhna	Likh-naa
To understand	Samajhna



?????: ???? ?????!!! ???? ???
Anjali: Hello Rahul!!! Kaise ho?
Anjali: Hello Rahul!! How are you?
?????: ??? ??? ??? ?????. ??? ???? ???
Rahul: Main theek hoon. Tum kaisi ho?
Rahul: I am fine. How are you?
?????: ??? ?? ??? ???. ???? ?? ?? ???? ????? ?????
Anjali: Main bhi theek hoon. Kya hum aaj kahin ghoomne chlein?
Anjali: I am fine too. Today shall we go out somewhere?
?????: ??? ????? ????? ??? ?? ???? ???? ???? ????.
Rahul: Haan kyon nhi? Chlo hum kahin khaana khane chlein.
Rahul: Yes, why not? Let’s go to eat.
?????: ??? ?? ??? ?????. ???? ?? ??? ??? ??, ????? ???? ?????
Anjali: Haan, yeh theek rhega. Mujhe bhi bhookh lgi hai, Lekin kahan chlein?
Anjali: Yes, this is a good idea. I am feeling hungry too, but where shall we go?
?????: ??? ?? ????? ?? ??? ???? ????????? ??? ???? ???, ???? ?? ?? ???? ????? ?? ?? ???? ???.
Rahul: Chlo hum school ke paas vale restaurant me chlte hain, vahan se hum movie dekhne bhi ja sakte hain.
Rahul: Let’s go to the restaurant near the school, from there we can go for a movie too.
?????: ???!! ?? ?? ???? ????? ??. ??? ?? ???? ??????? ?? ?? ???? ???.
Anjali: Vah!! ye to bahut badhiya hai. Chlo hum baki doston ko bhi bula lein.
Anjali: Wow!! This is a good idea. Let’s call our other friends too.
?????: ??? ??? ????? ?? ?????? ??? ????. ??? ???? ?? ????? ?? ?????? ???.
Rahul: Sabhi sath honge to jyada mza aayega. Main kareem aur kusum ko bulaata hoon.
Rahul: The more the merrier. I will call Kareem and Kusum.
?????: ??? ?? ???, ????? ?? ????? ?? ?????? ???. ?? ???? ??? ??? ???? ?? ????? ??? ??? ??? ??? ???? ???.
Anjali: Theek hai, main Kavita aur Rashmi ko bulati hoon. Hum thodi der me yahan hi milte hain phir sbhi sath chlenge.
Anjali: Fine, I will ask Kavita and Rashmi. We will meet here in a few and then we all will go together.
?????: ??? ??!! ?? 15 ???? ??? ????? ???.
Rahul: Theek hai! hum 15 minute me milte hain.
Rahul: Alright! let’s meet in 15 minutes.
In the above conversation, you will notice that words in bold are actually English words. Hindi is a very dynamic language and few words have been adapted from English to make the language simpler.
The words in Italics distinguish between male and female gender. Words denoting male gender always end with ‘aa’ ‘?’ and female gender ends with ‘ee’ ‘?’.
Practicing conversation is such a good way to remember commonly used words and also to practice grammar. I hope this lesson was helpful. Keep practicing till the next lesson..


Hindi Phrases
This page contains a table including the following: Hindi phrases, expressions and words in Hindi, conversation and idioms, Hindi greetings, and survival phrases. It also helps if you simply want to know what to say when chatting in Hindi!

Most of the sentences below are used for everyday life conversations, so they might come handy if you memorize them.

If you don't know how to say a word then check our alphabet in Hindi which can be found on the menu above to get some help.

To hear some of the sentence below make sure to check the Hindi Video page.

Hindi Phrases

    

English Phrases	Hindi Phrases
 
English Greetings	Hindi Greetings:
Hi!	Namastey!   ??????
Good morning!	Suprabhaat   ????????
Good evening!	Shubh sundhyaa.   ??? ??????
Welcome! (to greet someone)	Aapka swaagat hai!   ???? ?????? ????
How are you?	Aap kaisey hain?   ?? ???? ??? ?
I'm fine, thanks!	Mein theek hoon, shukriya!   ??? ??? ??? ?
And you?	Aur aap?   ?? ???
Good/ So-So.	Accha/ Theek-thaak   ?????/ ???-???
Thank you (very much)!	Shukriyaa (Bahut dhanyavaad)   ???????? (???? ???????)
You're welcome! (for "thank you")	***   ***
Hey! Friend!	Arrey, Dost!.   ???, ?????
I missed you so much!	Mujhey aapkee bahut yaad aaee.?   ???? ???? ???? ??? ????
What's new?	Kyaa chal rahaa hai?;  ???? ?? ??? ????
Nothing much	Zyaada kuch nahi   ?????? ??? ???? ?
Good night!	Shubh raatri.   ??? ???????
See you later!	Phir milen-gay.!   ???????
Good bye!	Alvida!   ???????
Asking for Help and Directions	
I'm lost	Hum kho gaye hain.   ?? ?? ??? ??? ?
Can I help you?	Kya mein aapki madad kar sakta/ sakti (female) hoon?
???? ??? ???? ??? ?? ???? /???? ??? ?
Can you help me?	Kya aap meri madad kar saktey hain?
???? ?? ???? ??? ?? ???? ??? ?
Where is the (bathroom/ pharmacy)?	saucaghara/ pharmacy kahaan hai?   ?????/ ???????? ???? ??
Go straight! then turn left/ right!	Seedhey jaaey! Phir banyae/ danyae mudiye
???? ????-??? ????-???? ????? ?
I'm looking for john.	Mein John ko dhoondh rahaa/ rahi (female) hoon.
??? ??? ?? ???? ???-??? ??? ?
One moment please!	Ek minat…   ?? ????
Hold on please! (phone)	Ek minat…   ?? ????
How much is this?	Yeh kaisey diyaa?   ?? ???? ???? ?
Excuse me ...! (to ask for something)	Kshama keejeeae…   ????? ????? ?
Excuse me! ( to pass by)	Kshama keejeeae…   ????? ????? ?
Come with me!	Mere saath aaeeyé!   ???? ??? ??? ?


 
    

How to Introduce Yourself	
 
Do you speak (English/ Hindi)?	Kyaa aap (angrézee/hindi) mein baat kar saktey hain?
???? ?? (????????-?????) ??? ??? ?? ???? ???
Just a little.	Bus thodaasaa.   ?? ??????
What's your name?	Aapka naam kyaa hai?   ???? ??? ???? ??
My name is ...	Meraa naam …hai.   ???? ???..... ?? ?
Mr.../ Mrs.…/ Miss…	Shree../Shreematee…/Kumaari…/Kumar (Master)
????-???????-??????-?????
Nice to meet you!	Aapsey milkar khushi huee!   ???? ????? ???? ??? ?
You're very kind!	Aap bahut dayaloo hain!   ?? ???? ????? ??? ?
Where are you from?	Aap kahaan sey hain?   ?? ???? ?? ??? ?
I'm from (the U.S/ India)	Mein (amerika/ bharata) se hoon.   ??? (???????-????) ?? ??? ?
I'm (American)	Mein amrikan hoon.   ??? ??????? ??? ?
Where do you live?	Aap kahaan rehtey hain?   ?? ???? ???? ???
I live in (the U.S/ India)	Mein (US/ bharata) mein rehtaa/ rehtee (female) hoon.
??? (US-????) ??? ????-???? ??? ?
Did you like it here?	Kyaa aap ko yahaan accha lagtaa hai?
???? ???? ???? ????? ???? ??
India is a wonderful country	Bharat ek adbhut desh hai   ???? ?? ?????? ??? ?? ?
What do you do for a living?	Aap kyaa kaam kartey hain?   ?? ???? ??? ???? ???
I work as a (translator/ businessman)	Mera apnaa vyaapaar hai (I have my own business)
???? ???? ??????? ?? ?
I like Hindi	Mujhey Hindi bhaashaa acchee lagtee hai.
???? ????? ???? ????? ???? ???

How to Introduce Yourself	
 
Do you speak (English/ Hindi)?	Kyaa aap (angrézee/hindi) mein baat kar saktey hain?
???? ?? (????????-?????) ??? ??? ?? ???? ???
Just a little.	Bus thodaasaa.   ?? ??????
What's your name?	Aapka naam kyaa hai?   ???? ??? ???? ??
My name is ...	Meraa naam …hai.   ???? ???..... ?? ?
Mr.../ Mrs.…/ Miss…	Shree../Shreematee…/Kumaari…/Kumar (Master)
????-???????-??????-?????
Nice to meet you!	Aapsey milkar khushi huee!   ???? ????? ???? ??? ?
You're very kind!	Aap bahut dayaloo hain!   ?? ???? ????? ??? ?
Where are you from?	Aap kahaan sey hain?   ?? ???? ?? ??? ?
I'm from (the U.S/ India)	Mein (amerika/ bharata) se hoon.   ??? (???????-????) ?? ??? ?
I'm (American)	Mein amrikan hoon.   ??? ??????? ??? ?
Where do you live?	Aap kahaan rehtey hain?   ?? ???? ???? ???
I live in (the U.S/ India)	Mein (US/ bharata) mein rehtaa/ rehtee (female) hoon.
??? (US-????) ??? ????-???? ??? ?
Did you like it here?	Kyaa aap ko yahaan accha lagtaa hai?
???? ???? ???? ????? ???? ??
India is a wonderful country	Bharat ek adbhut desh hai   ???? ?? ?????? ??? ?? ?
What do you do for a living?	Aap kyaa kaam kartey hain?   ?? ???? ??? ???? ???
I work as a (translator/ businessman)	Mera apnaa vyaapaar hai (I have my own business)
???? ???? ??????? ?? ?
I like Hindi	Mujhey Hindi bhaashaa acchee lagtee hai.
???? ????? ???? ????? ???? ???
I've been learning Hindi for 1 month	Main ek maheeney sey Hindi seekh raha/ rahee (female) hoon.
??? ?? ??????? ????? ??? ???-??? ??? ?
Oh! That's good!	Yeh accha hai!   ?? ????? ?? ?
How old are you?	Aapkee umar kyaa hai?   ???? ??? ???? ??
I'm (twenty, thirty...) years old.	Mein (bees, tees…) saal ka hoon/ ki hoon (female)
??? (???, ???) ??? ?? ???- ?? ??? ?
I have to go	Mujhey jaana hogaa   ???? ???? ???? ?
I will be right back!	Mein turant laut key aaoongaa/ aaoongi (female)
??? ????? ??? ?? ?????-????? ?
Wish Someone Something	
Good luck!	Shubh Kaamnaayein   ??? ???????
Happy birthday!	Janamdin kee shubhaechaen   ?????? ?? ??????????
Happy new year!	Naaey saal kee shubhaechaen   ?? ??? ?? ??????????
Merry Christmas!	Christmas kee badhaaeeyaan   ??????? ?? ???????
Congratulations!	Badhaaee ho!   ???? ??
Enjoy! (for meals...)	Bhog keejeeae   ??? ?????
I'd like to visit India one day	Mein kabhi Bharat jaana chahoongaa/ chahoongi (female)
??? ?? ???? ???? ???????- ??????? ?
Say hi to John for me	John ko meri taraf sey namastey kehna.
??? ?? ???? ??? ?? ?????? ???? ?
Bless you (when sneezing)	(No expression)   
Good night and sweet dreams!	Shubh raatri   ??? ?????? ?
Solving a Misunderstanding	
I'm Sorry! (if you don't hear something)	Kyaa aap issey dohraa saktey hain?   ???? ?? ??? ????? ???? ???
Sorry (for a mistake)	Kshamaa/ maafee chaahta/ chaahti (female) hu.
?????- ???? ?????/ ????? ???
No Problem!	Koee baat nuhee   ??? ??? ???? ?
Can You Say It Again?	Kyaa aap issey dohraa saktey hain?   ???? ?? ??? ????? ???? ???
Can You Speak Slowly?	Kyaa aap dheerae baat karengae?   ???? ?? ???? ??? ??????
Write It Down Please!	Kripaya karkey yeh likkh deejeeae.
????? ???? ?? ??? ????? ?
I Don't Understand!	Mujhey samajh mein nahi aataa.   ???? ??? ??? ???? ??? ?
I Don't Know!	Mujhey nahi maloom   ???? ???? ????? ?
I Have No Idea.	Mujhey iss cheez kaa kuchh pata nahi hai
???? ?? ??? ?? ??? ??? ???? ?? ?
What's That Called In Hindi?	Issey Hindi mein kyaa kahtey hain?   ??? ????? ??? ???? ???? ??? ?
What Does "gato" Mean In English?	Angrezi mein “maloom” ka kyaa arth hoga?
???????? ???“?????” ?? ???? ???? ???? ?
How Do You Say "Please" In Hindi?	Hindi mein “please” kaisey kahtey hain?   ????? ??? “?????” ???? ???? ???
What Is This?	Yeh kyaa hai?   ????? ??? ??? ???? ???? ???
My Hindi is bad.	Meri Hindi kucch khaas nahi hai.   ???? ????? ??? ??? ???? ?? ?
I need to practice my Hindi	Mujey Hindi ka or abhyaas karnaa hogaa
???? ????? ?? ?? ?????? ???? ???? ?
Don't worry!	Chinta mat karo!   ????? ?? ??? ?
Hindi Expressions and Words	
Good/ Bad/ So-So.	Accha/ Boora/ Theek-thaak   ?????-????-(???-???)
Big/ Small	Bada Chhota   ???-????
Today/ Now	Aaj/ Abhi   ??-???
Tomorrow/ Yesterday	Kal/ Kal   ??-??
Yes/ No	Haan/ Naa or Nuhi   ???- ??-????
Here you go! (when giving something)	Ye leejeeay (polite)/ Ye lo   ?? ?????- ?? ??
Do you like it?	Kyaa aap ko yeh accha lagta hai?   ???? ???? ?? ????? ???? ??
I really like it!	Mujhey yeh bahut accha lagta hai   ???? ?? ???? ????? ???? ???
I'm hungry/ thirsty.	Mujhey bhookh lagi hai/ Mujhey pyaas lagi hai   ???? ??? ??? ???
In The Morning/ Evening/ At Night.	Subah ko/ Shaam ko/ Raat ko   ???? ??- ??? ??-??? ??
This/ That. Here/There	Yeh/ woh. Yahaan/ wahaan   ??-??-????-????
Me/ You. Him/ Her.	Hum/ Tum. Voh/ Voh   ??-???-??-??
Really!	Such mein?   ?? ???
Look!	Dekkho!   ????
Hurry up!	Jaldi karo!   ????? ???
What? Where?	Kyaa? Kahaan?   ????? ?????
What time is it?	Kitney bajey hain?   ????? ??? ??? ?
It's 10 o'clock. 07:30pm.	Dus bajey hain. Shyaam ke Saat buj kar tees minat hue hain.
?? ??? ???, ??? ?? ??? ?? ?? ??? ???? ??? ???
Give me this!	Mujhey ye cheez chaaheeye!   ???? ?? ???? ??????
I love you!	Mei tumsey pyaar kartaa/ karti (female) hu!
??? ????? ????? ????/ ???? ????
I feel sick.	Meri Tabiyut kharaab hai.   ???? ????? ???? ???
I need a doctor	Mujhey Doctor kee zaroorat hai   ???? ?????? ?? ????? ???
One, Two, Three	Ek, Dow, Teen   ??, ??, ???
Four, Five, Six	Chaar, paanch, chhey   ???, ????, ??
Seven, Eight, Nine, Ten	Saat, Aath, Nao, Dus   ???, ??, ??, ??


Read more: http://www.linguanaut.com/english_hindi.htm#ixzz62OphtBbf
Read more: http://www.linguanaut.com/english_hindi.htm#ixzz62OpJkOjE